NO ./assets/textures/nonexistent.xpm
SO ./assets/textures/south.xpm
WE ./assets/textures/west.xpm
EA ./assets/textures/east.xpm
F 60,60,60
C 135,206,235

111111111
100000001
10000N001
100000001
111111111