NO ./assets/textures/north.xpm
SO ./assets/textures/south.xpm
WE ./assets/textures/west.xpm
EA ./assets/textures/east.xpm
F 60,60,60
C 135,206,235

1111111111111111111111111111111111
1000000000110000000000001000000001
1011000001110000000000001000000001
1001000000000000000000000000000001
1011000001110000000000001000000001
1000000001110111111111111011111111
1000011111110000000000001100000001
1000011111110101001000001100000001
1000000011010110000100000000000001
1000000000000110000100001100000001
100000000000011000010000110000N001
1000000000000110000100001100000001
1000000110000110000100001100000001
1110011110000110000100001100000001
1000001100000110000100001100000001
1000001100000110000100001100000001
1000001100000110000100001100000001
1000001111111111111100001100000001
1000000000000000000000001100000001
1000000000000000000000001100000001
1000000000000000000000001100000001
1111111111111111111111111111111111