NO ./assets/textures/north.xpm
SO ./assets/textures/south.xpm
W ./assets/textures/west.xpm
EA ./assets/textures/east.xpm
F 60,60,60
C 135,206,235

1111111111
1000000001
1000000001
100000N001
1111111111
