NO ./assets/textures/north.xpm
SO ./assets/textures/south.xpm
WE ./assets/textures/west.xpm
EA ./assets/textures/east.xpm
F 60,60,60
C 135,206,235

1111111111111111111
10000000010000000001
100000000100000000001
100000N00111111000111111
100000000100000000000001
100000000100000000000001
100000000111000011111111
100000000000000000000001
100000000111111111111111
1000000001
1111111111
